52
42
32
32
0   1   8   9   10  8   9   10  8   9   10  11  12  13  8   9   10  8   9   10  8   9   10  8   9   10  5   6   7   8   9   10  5   6   7   8   9   10  8   9   10  8   9   10  8   9   10  8   9   10  0   1
14  15  22  23  24  22  23  24  22  23  24  25  26  27  22  23  24  22  23  24  22  23  24  22  23  24  19  20  21  22  23  24  19  20  21  22  23  24  22  23  24  22  23  24  22  23  24  22  23  24  14  15
28  29  36  37  38  36  37  38  36  37  38  39  40  41  36  37  38  36  37  38  36  37  38  36  37  38  33  34  35  36  37  38  33  34  35  36  37  38  36  37  38  36  37  38  36  37  38  36  37  38  28  29
0   1   8   9   10  11  12  13  8   9   10  8   9   10  8   9   10  5   6   7   8   9   10  11  12  13  8   9   10  8   9   10  8   9   10  11  12  13  8   9   10  5   6   7   8   9   10  8   9   10  0   1
14  15  22  23  24  25  26  27  22  23  24  22  23  24  22  23  24  19  20  21  22  23  24  25  26  27  22  23  24  22  23  24  22  23  24  25  26  27  22  23  24  19  20  21  22  23  24  22  23  24  14  15
28  29  36  37  38  39  40  41  36  37  38  36  37  38  36  37  38  33  34  35  36  37  38  39  40  41  36  37  38  36  37  38  36  37  38  39  40  41  36  37  38  33  34  35  36  37  38  36  37  38  28  29
0   1   8   9   10  8   9   10  5   6   7   8   9   10  8   9   10  8   9   10  8   9   10  8   9   10  8   9   10  5   6   7   8   9   10  8   9   10  8   9   10  8   9   10  8   9   10  8   9   10  0   1
14  15  22  23  24  22  23  24  19  20  21  22  23  24  22  23  24  22  23  24  22  23  24  22  23  24  22  23  24  19  20  21  22  23  24  22  23  24  22  23  24  22  23  24  22  23  24  22  23  24  14  15
28  29  36  37  38  36  37  38  33  34  35  36  37  38  36  37  38  36  37  38  36  37  38  36  37  38  36  37  38  33  34  35  36  37  38  36  37  38  36  37  38  36  37  38  36  37  38  36  37  38  28  29
0   1   8   9   10  11  12  13  8   9   10  8   9   10  5   6   7   8   9   10  8   9   10  5   6   7   8   9   10  8   9   10  8   9   10  5   6   7   8   9   10  8   9   10  11  12  13  8   9   10  0   1
14  15  22  23  24  25  26  27  22  23  24  22  23  24  19  20  21  22  23  24  22  23  24  19  20  21  22  23  24  22  23  24  22  23  24  19  20  21  22  23  24  22  23  24  25  26  27  22  23  24  14  15
28  29  36  37  38  39  40  41  36  37  38  36  37  38  33  34  35  36  37  38  36  37  38  33  34  35  36  37  38  36  37  38  36  37  38  33  34  35  36  37  38  36  37  38  39  40  41  36  37  38  28  29
0   1   8   9   10  8   9   10  8   9   10  8   9   10  8   9   10  8   9   10  8   9   10  8   9   10  8   9   10  11  12  13  8   9   10  8   9   10  8   9   10  5   6   7   8   9   10  8   9   10  0   1
14  15  22  23  24  22  23  24  22  23  24  22  23  24  22  23  24  22  23  24  22  23  24  22  23  24  22  23  24  25  26  27  22  23  24  22  23  24  22  23  24  19  20  21  22  23  24  22  23  24  14  15
28  29  36  37  38  36  37  38  36  37  38  36  37  38  36  37  38  36  37  38  36  37  38  36  37  38  36  37  38  39  40  41  36  37  38  36  37  38  36  37  38  33  34  35  36  37  38  36  37  38  28  29
0   1   8   9   10  8   9   10  5   6   7   8   9   10  8   9   10  8   9   10  5   6   7   8   9   10  8   9   10  8   9   10  5   6   7   8   9   10  11  12  13  8   9   10  8   9   10  8   9   10  0   1
14  15  22  23  24  22  23  24  19  20  21  22  23  24  22  23  24  22  23  24  19  20  21  22  23  24  22  23  24  22  23  24  19  20  21  22  23  24  25  26  27  22  23  24  22  23  24  22  23  24  14  15
28  29  36  37  38  36  37  38  33  34  35  36  37  38  36  37  38  36  37  38  33  34  35  36  37  38  36  37  38  36  37  38  33  34  35  36  37  38  39  40  41  36  37  38  36  37  38  36  37  38  28  29
0   1   11  12  13  8   9   10  8   9   10  8   9   10  11  12  13  8   9   10  8   9   10  8   9   10  8   9   10  8   9   10  8   9   10  8   9   10  8   9   10  8   9   10  5   6   7   8   9   10  0   1
14  15  25  26  27  22  23  24  22  23  24  22  23  24  25  26  27  22  23  24  22  23  24  22  23  24  22  23  24  22  23  24  22  23  24  22  23  24  22  23  24  22  23  24  19  20  21  22  23  24  0   1
28  29  39  40  41  36  37  38  36  37  38  36  37  38  39  40  41  36  37  38  36  37  38  36  37  38  36  37  38  36  37  38  36  37  38  36  37  38  36  37  38  36  37  38  33  34  35  36  37  38  14  15
0   1   8   9   10  5   6   7   8   9   10  8   9   10  8   9   10  8   9   10  8   9   10  11  12  13  8   9   10  5   6   7   8   9   10  8   9   10  5   6   7   8   9   10  8   9   10  8   9   10  28  29
14  15  22  23  24  19  20  21  22  23  24  22  23  24  22  23  24  22  23  24  22  23  24  25  26  27  22  23  24  19  20  21  22  23  24  22  23  24  19  20  21  22  23  24  22  23  24  22  23  24  0   1
28  29  36  37  38  33  34  35  36  37  38  36  37  38  36  37  38  36  37  38  36  37  38  39  40  41  36  37  38  33  34  35  36  37  38  36  37  38  33  34  35  36  37  38  36  37  38  36  37  38  14  15
0   1   8   9   10  8   9   10  8   9   10  8   9   10  5   6   7   8   9   10  8   9   10  8   9   10  8   9   10  8   9   10  8   9   10  5   6   7   8   9   10  8   9   10  11  12  13  8   9   10  28  29
14  15  22  23  24  22  23  24  22  23  24  22  23  24  19  20  21  22  23  24  22  23  24  22  23  24  22  23  24  22  23  24  22  23  24  19  20  21  22  23  24  22  23  24  25  26  27  22  23  24  0   1
28  29  36  37  38  36  37  38  36  37  38  36  37  38  33  34  35  36  37  38  36  37  38  36  37  38  36  37  38  36  37  38  36  37  38  33  34  35  36  37  38  36  37  38  39  40  41  36  37  38  14  15
0   1   8   9   10  8   9   10  5   6   7   8   9   10  8   9   10  8   9   10  8   9   10  5   6   7   8   9   10  11  12  13  8   9   10  8   9   10  8   9   10  5   6   7   8   9   10  8   9   10  28  29
14  15  22  23  24  22  23  24  19  20  21  22  23  24  22  23  24  22  23  24  22  23  24  19  20  21  22  23  24  25  26  27  22  23  24  22  23  24  22  23  24  19  20  21  22  23  24  22  23  24  0   1
28  29  36  37  38  36  37  38  33  34  35  36  37  38  36  37  38  36  37  38  36  37  38  33  34  35  36  37  38  39  40  41  36  37  38  36  37  38  36  37  38  33  34  35  36  37  38  36  37  38  14  15
0   1   8   9   10  11  12  13  8   9   10  8   9   10  8   9   10  5   6   7   8   9   10  8   9   10  8   9   10  8   9   10  8   9   10  8   9   10  11  12  13  8   9   10  8   9   10  8   9   10  28  29
14  15  22  23  24  25  26  27  22  23  24  22  23  24  22  23  24  19  20  21  22  23  24  22  23  24  22  23  24  22  23  24  22  23  24  22  23  24  25  26  27  22  23  24  22  23  24  22  23  24  0   1
28  29  36  37  38  39  40  41  36  37  38  36  37  38  36  37  38  33  34  35  36  37  38  36  37  38  36  37  38  36  37  38  36  37  38  36  37  38  39  40  41  36  37  38  36  37  38  36  37  38  14  15
0   1   8   9   10  8   9   10  5   6   7   8   9   10  8   9   10  8   9   10  8   9   10  8   9   10  11  12  13  8   9   10  5   6   7   8   9   10  8   9   10  8   9   10  5   6   7   8   9   10  28  29
14  15  22  23  24  22  23  24  19  20  21  22  23  24  22  23  24  22  23  24  22  23  24  22  23  24  25  26  27  22  23  24  19  20  21  22  23  24  22  23  24  22  23  24  19  20  21  22  23  24  0   1
28  29  36  37  38  36  37  38  33  34  35  36  37  38  36  37  38  36  37  38  36  37  38  36  37  38  39  40  41  36  37  38  33  34  35  36  37  38  36  37  38  36  37  38  33  34  35  36  37  38  14  15
0   1   8   9   10  8   9   10  8   9   10  8   9   10  11  12  13  8   9   10  5   6   7   8   9   10  8   9   10  8   9   10  8   9   10  8   9   10  5   6   7   8   9   10  8   9   10  8   9   10  28  29
14  15  22  23  24  22  23  24  22  23  24  22  23  24  25  26  27  22  23  24  19  20  21  22  23  24  22  23  24  22  23  24  22  23  24  22  23  24  19  20  21  22  23  24  22  23  24  22  23  24  0   1
28  29  36  37  38  36  37  38  36  37  38  36  37  38  39  40  41  36  37  38  33  34  35  36  37  38  36  37  38  36  37  38  36  37  38  36  37  38  33  34  35  36  37  38  36  37  38  36  37  38  14  15
0   1   8   9   10  11  12  13  8   9   10  8   9   10  8   9   10  8   9   10  8   9   10  8   9   10  8   9   10  8   9   10  8   9   10  8   9   10  8   9   10  8   9   10  11  12  13  8   9   10  28  29
14  15  22  23  24  25  26  27  22  23  24  22  23  24  22  23  24  22  23  24  22  23  24  22  23  24  22  23  24  22  23  24  22  23  24  22  23  24  22  23  24  22  23  24  25  26  27  22  23  24  0   1
28  29  36  37  38  39  40  41  36  37  38  36  37  38  36  37  38  36  37  38  36  37  38  36  37  38  36  37  38  36  37  38  36  37  38  36  37  38  36  37  38  36  37  38  39  40  41  36  37  38  14  15